TILEMAP
40 30 							-- Size of tile map in tiles
16 16 							-- Tile size & block size
images/tilesets/tileset02.png 	-- Tilesheet
11 5 							-- Number of tiles in tilesheet
1111111111111111111111111111111111111111
1111111111111111111111111111111111111111
1111111111111111111111111111111111111111
1111111                          1111111
1111111                          1111111
1111111                          1111111
1111111                          1111111
11111                              11111
11111                              11111
111                                  111
111           RRRRRRRRRRRR           111
111                                  111
111                                  111
111       RRR              RRR       111
111                                  111
111                                  111
111RRRRRR                      RRRRRR111
111                                  111
111                                  111
111                                  111
111          RRRRRRRRRRRRRR          111
111                                  111
111                                  111
111                                  111
111     RRRRRRRR        RRRRRRRR     111
111                                  111
111                                  111
111                                  111
1111111111111111111111111111111111111111
1111111111111111111111111111111111111111